010001000000000100000
010101111101110101110
000100000100010101000
111111110111011101011
000000010001000001000
011111111101011111110
010000000001010000010
010111111111010111110
010101000100010100000
010101010101110101110
000100010100010100010
011101110111010101010
010001000001000101010
011111010111110111010
010000010100000100010
010111011101111101110
010100010001000101000
010111110111010101010
010000000001010001010
011111111111011111010
000000000000010000010
