0000010001010000000000000000000100000001
1111010101010111110111111111110101111101
0001010101010000010001000100010001010001
0111010101010111111101010101011111010111
0001010100010100000001010001000001000001
1101010111110101111111011111111111011111
0001010001000101000001000100000001010001
0111011101011101010101110101111101011101
0001000101010001010100010000000101000101
0111110101010111010111011111110101110101
0100000100010100010001000001010101000101
0101111111110111011101111101010101011101
0101000100010100010001000101000101010001
0101010101010101110111011101111101010101
0100010001000101000101000100010001010101
0111111111111111011101010111010111010111
0100000000000001000100010100010001010001
0101011111111101110101110101110101011101
0101010000000100000101010001000101010001
0111011111011111111101011111011101010111
0000000001000001000001010000010001010001
0111111101111101011111010111110111011101
0001000101000101000000000100010100010001
0101011101010101111111111101010101110111
0100010001010001010000000001010101000001
0111110111011101010111011111010101011101
0100000101000100010101010001010101010101
1101111101011111110101010101110101010101
0000000101000100000101010100000100010001
0101110101010101111101010111111111110111
0101000100010000010001000100000000010101
0101111101111111010101111101111101010101
0101000101000100000100010001000101010001
0111010101010111111111010111010101111101
0100010101010000010000010100010100010001
0101110111011111011111110101110111010111
0100010000010000010000000100010001000101
0111011111110111110101111111111101111101
0000010000000000000100000000000000000001
1111111111111111111111111111111111111111
