0100010001000000000001010000000100010001
0101010101011111111101010111010101010101
0101010101010100000100010100010001010101
0111010101010101110111010101111111010101
0100010100010101010001010101000000000101
0101110111110101011101011101110111111111
0100010001000101000101000100010100010001
0101011101010101110101110101011101010101
0101000001010001000100010101000001000101
0111110101111101011101110101111111011101
0001000100000100010001000101000001000101
1101111111110111110111011111011101111101
0100000000010100000100010000010001000001
0111111111010101011101110111111101011111
0000000101000101000001000100000101000001
1101110101111111110111110111010101011101
0001010100010000010100000100010101010001
0111010101011101010101111101111101110111
0001000001000001010001000001000100010001
0101011111111101011111011111010111011101
0101010100000101000001000001010001000101
0101010101110101110111011101010111110101
0101000100010101000100010100010000010101
0101011101110101011101110111111111010101
0101010001000101000100000000000001000101
0101110111011111110111111111111101111101
0100000001010000010001000100000101000101
0111111111010101111101011101110101010101
0100000100010100000000010001010101010101
0101010101110111111111110111010101010101
0101010101000000010000010000010100010101
0111011101111111110111011101110111010101
0000000101000000000101010001010001010101
1111110101011111111101010111010101010101
0001000100010000010001010100010101010101
0111011111111101010111010111010111010101
0001000100000101010001000100010001010101
0101010101110101011101111101011101010101
0100010001000001000000000001000100010001
1111111111111111111111111111111111111111
