0001000000010001000100000000000001000101
1101010111110101010101111111011101010101
0001010000010101010100000001010000010001
0111111111010101010101111111011111110111
0000000100010100010001000001000001010101
1111110101110111111111011101111101010101
0001000101000100000001000100000001010001
0101011101011101111111110111111111011101
0100010000000001000000000100000000000001
0111111111111111010111111111111101111111
0001000001010000010100000000000101000001
1101011101010111111101111111110101011101
0100010000010001000000000000010100010101
0111110111111101011111111111110111010101
0100000100000100000000000100000100010001
0101111101110111111111110101111111111101
0001000001010100000001010100000100000101
0111011101010101111101010111110101110101
0100010001010001000101000000010001010101
0111010111011111010101111111011111010101
0001010100010000010100010000010000010101
1101010101011111110111010111111111010111
0101010101000100010001010001000000010001
0101010101110101011101011101110111111101
0101010101010101000001000100010100000101
0101110101010101111101110111010101110101
0100010101000001000100010001000101000101
0111010101111101010111111101011101011101
0001000100010001010000010101010001010001
0101111111011111011111010101110111010101
0100000001010001000100010101000101000101
0111011101010101010101110101011101110101
0001010000010100010101000001000101000101
1111010111110111111101011111110101011111
0000010001010101000001000001000100010001
0101111101010101010111111101010111011101
0100010000010101010100010001010001000001
0111011111110101011101010111111101111101
0001000000000001000001000000000001000001
1111111111111111111111111111111111111111
